affordable->dvd;case
dont->week;dont
nicer->deal;nicer;dvd;vcr;combo;crappiness;gift
extra->feature;dvd;player
certain->problem;dvd;player;point;movie;access;feature;apex;disc;message
slim->player;dvd;panel;look
cheap->dvd;player;show;scratch;base;plate;sony;feel
sleek->player;work
expensive->apex;price;problem;dvd;medium;disc;surprise;anything;burner
second->brother;house;didn;work;catch;movie
good->lot;feature;front;panel;button;money;apex;machine;dvds;music;cd;loading;disc;dvd;review;variety;site;unit;format;jpeg;pic;feeling;shipping;part;quality;feel;discs;picture;sound;notch;dts;form;factor;look;output;connection;tv
annoying->unit;life
fine->disc;spin;noise;dvd;design;work;movie
progressive->manufacturer;toshiba;pioneer;dvd;play;mpeg2;mpeg1;video;jpeg;wma;cdr;cdrw;dvdr;dvdrw;course;movie;aiff;feature;week;scan;quality;button;remote;control
best->dvd;price;set;feature;item;category;dollar
different->cd;jpeg;picture;dvd;apex;player;review;value;money;variety;site;unit;tv;multitude;connection;method;signal;machine;bunch;format
lemon->player;condition
cd-r->jpeg;plus;artist;accident;file;vcd;formatting
decent->shipping;tax
top->feel;discs;dts;dvd;top;disc
negative->picture
occasional->year;exception;motor;dvd;problem;point;movie;access;feature
few->problem;movie;picture;moment;week;player;case;cd;play;feature;size;layout;remote
only->experience;problem;player;air;picture
other->machine;feature;dvd;player;condition;work;model;month;friend;season;problem;medium;disc;surprise;anything;burner;remote;apex;disney;movie;message;consumer;report;brand;experience;review;product;format;jpeg;pic;feeling;color;look;signal;tv;picture;noise
myriad->myriad;feature
low->design;look;player;manufacturer;toshiba;pioneer
easy->setup;picture;zoom;form
simplest->button;remote;control
new->pirate;feature;course;couple;cd;play
white->tv;picture;moment
several->support;site;telephone;line;email;dvd;number;week;signal;player;month;friend;season;instance;movie;dvds;unit;tv;multitude;connection;method;machine
numerous->support
attractive->size;layout;remote
real->look
full->jpgs
standard->player;feature;item;category
non-american->macrovision;baby;region
small->feature;layout;remote;quality;show;scratch;base;plate;sony;feel
pricey->player;look
regular->jpeg;plus;artist;accident;file;vcd;formatting
multi-format->dvd;case
disapointed->dvd
front->life
crappy->apex;unit
rental->problem;point;movie;access;feature;medium;vcd;year
easiest->button;remote;control
special->player;dvd;problem;point;movie;access;feature
cool->mp3;cd;jpeg;picture;dvd;panel;player;look
great->connector;quality;feature;front;panel;button;layout;money;player;nicer;vcr;combo;crappiness;gift;reliability;tv;letterbox;screen;image;work
audio->picture;ability;vcd;disc
remote->feel;layout;filename;mp3s;name;cycle;zoom;setting;size;sorry;option;button;remote;apex;model;respond;operator;error;usage;claiming;dvd;player;none;work;awkward
reviews-my->picture
third->price
older->philip
high-end->apex;price
reliable->report;experience;review;product
inexpensive->set;feature;item;category;hour
favorite->player
mixed->price
stylish->player;dvd
more->set;feature;item;category;money;deal;nicer;vcr;combo;crappiness;gift;problem;medium;disc;surprise;anything;burner;update;silver;consumer;report;apex;brand;experience;review;product
loud->player;disc;spin
original->mp3s;jpegs
first->incident;dvds;purchase;dvd;froze;week;case;access;menus
