outdoor->plenty;light;object
photo->anybody;pic;camera;auto;mode;spin;dial;shutter;priority;speed;subject;length;program;ideal;feature
cheap->plastic
fantastic->price
bright->lag;quality;flash
plug-in->show;hardware;software
perfect->megapixel;photo;ability
better->shape;device;squarer;weight;battery;life;powershot;buyer;price;silver;magnesium;finish;line;grip;image;conjunction;flash;system;limitation;resolution;limit;picture;light;zoom
on-screen->scene;push;button
only->review;fact;viewfinder;nit;camera;strap;neck;shot;issue;cap;view;lcd
other->halfway;position;stopaction;photo;reviewer;megapixel;silver;magnesium;finish;line;grip
easy->ability;computer;software;sort;upload;picture;fact;trip;week;group;control;battery;charge;casing;lcd;screen;pull;direction;button;zoom;price;detail;use;swivel;feature;option;fiance;stamp;approval;flash;lense;filter;choice;shutter;speed;duration
main->camera;subject;depth
4mp->market;amateur;photographer;photo;detail;use;swivel;lcd;screen;feature;option;software;fiance;stamp;approval;expectation
swivel->photo;detail;camera;use;swivel;lcd;feature;option;software;fiance;stamp;approval
good->place;feature;option;photography;zoom;unit;feel
spectacular->photo
big->camera
legitimate->review;fact;viewfinder
advanced->power;photography;control
non-slr->market
tonal->quality;megapixel;detail;color;response;view
customizable->battery;duration
manual->flagship;series;camera;megapixel;picture;touch;brilliance;adjustment;option;shutter;priority;aperature;dream;automode;flexibility;aperture;mode;access;selection;speed;menu;focus;scene;push;button;feature;photography
topnotch->photo
shutter->dream;automode;flexibility;aperture;shutter;mode;adjustment;option;aperature;control;spin;dial;subject;length;program;ideal;photo;quality;feature;access;selection;menu
bad->card
small->camera;subject;depth
smaller->camera;shutter;speed;type;battery;system;need;charging
built-in->lag;light;quality;camera;subject;depth
first-class->buyer;price
best->megapixel;detail;balance;color;response;view;price;drop;photo;zoom;market;function;viewfinder;lcd;work;instance;picture;loss;setting;fine
bottom->lcd;picture;camera;feature;ability;flash;lense;filter;choice
creative->progam;auto;photo;setting
above->photo;detail;camera;use;swivel;lcd;screen;feature;option;software;fiance;stamp;approval
blurry->picture;zoom;work;addition;blurry
available->price;drop;bargain
full->flagship;series;camera;megapixel;picture;touch;brilliance;spin;dial;shutter;priority;speed;subject;length;program;ideal;photo;quality
postage-stamp->picture
extreme->field
great->weight;control;battery;charge;casing;zoom;work;addition;blurry;detail;online;site;review;feature;speed;quality;flexibility;automation;convenience;offer;color;sharpness;doubt;imaging;rice;grain;balance;lcd;metering;photo;use;swivel;option;fiance;stamp;approval;fire;shot;kid;sparkler;noise;term;shoot
last->detail;camera;use;swivel;lcd;screen;feature;option;software;fiance;stamp;approval
many->picture;camera;quality;combination;ease;use;flexibility;option;feature;shutter;speed
larger->quality;light;zoom
tremendous->dream;automode;aperture;priority;shutter;mode
first->software;image;shoot;mode;mbyte;pic;film;toy
major->design
finest->category
useful->camera;shutter;speed
unsatisfactory->lag;flash
powerful->camera;feature;ability;flash;lense;filter;choice
functional->online;site;depth;review;feature;speed;picture;quality;flexibility;automation;convenience;camera;offer
visible->angle;lcd;bother;flaw;camera;image
tiny->picture
add-on->photo;detail;camera;use;swivel;lcd;screen;feature;option;software;fiance;stamp;approval
aperature->option;shutter;aperature;control
little->series;megapixel;control;picture;touch;brilliance;viewfinder;image;button;awkward
long->lag;light;quality;flash;battery;camera;power;knockoff;charger
chrome->control;battery;charge;software
least->detail;camera;use;swivel;lcd;screen;feature;option;software;fiance;stamp;approval
wonderful->shutter;picture;auto;mode;joe;camera;feature
low->sort;action;camera;dust;problem;picture;shutter;second;quality;zoom
flexible->camera;feature;ability;flash;lense;filter;choice
white->picture
minor->camera;strap;neck;shot;viewfinder;image;photography;issue;cap;view;lcd
more->image;shoot;mode;mbyte;g2;feature;camera;stitch;picture;log;website;battery;knockoff;charger
flat->flash;produce;harsh;image;spot
enormous->camera
slr-like->flagship;series;megapixel;control;picture;touch;brilliance
optical->photo;detail;use;swivel;lcd;screen;feature;option;software;fiance;stamp;approval;work;addition;picture;blurry;quality;light;price
external->produce;harsh;image;spot;shoe;quality;money;metz;line;camera;feature;ability;lense;filter;choice
excellent->magnesium;finish;line;exposure;control;progam;auto;photo;setting;shutter;halfway;position;stopaction;reviewer;functionality;picture;breeze;quality;combination;ease;use;flexibility;option;budget
highest->work;addition;picture;blurry
5mp->photo;detail;camera;use;swivel;lcd;screen;feature;option;software;fiance;stamp;approval
intuitive->camera
cheapest->lcd;work;instance
stunning->hardware
beautiful->photo;detail;camera;use;swivel;lcd;screen;feature;option;software;fiance;stamp;approval;battery;duration
ive->exposure;color;film;image;youre;camera;quality;conjunction;flash;system;limitation;resolution;limit
dedicated->flash
pro->option;photography
proven->quality
comfortable->price
high->dial;shutter;priority;speed;subject;length;program;mode;camera;ideal;photo;reputation;image
raw->exposure;color;film;world;quality;conjunction;flash;system;limitation;resolution;limit;complaint;shoot;mbyte;setting;adobe;show
sharp->magnesium;finish;line;grip;camera
photorealistic->image;camera
4-times->quality;light;zoom
harsh->flash;produce;harsh;image;spot
same->auto;mode;joe
configurable->battery;duration
ideal->dial;shutter;priority;speed;subject;length;program;mode;camera;ideal;photo
internal->produce;harsh;image;spot
digital->software;sort;upload;picture;quality;color;sharpness;doubt;imaging;rice;grain;zoom;work;addition;blurry;problem;fringing;disappointment;feature;shutter;speed;market;toy;catch;unresponsiveness;shot;price;drop;bargain;battery;life;drawback;reef;powershot;buyer;photo;moment
extended->faster;lense;top;class
third-party->flash
most->viewfinder;angle;bother;youre;image;pic;film;battery;life;drawback;reef;feature;option;photography;compactflash;card
moveable->lcd
focal->dial;shutter;priority;speed;subject;program;mode;camera;ideal;photo;quality
lower->barrel;part;viewfinder;lcd
short->camera
remote->photo;shutter;picture
faster->faster;top;class
4x->photo;detail;use;swivel;lcd;screen;feature;option;software;fiance;stamp;approval;price
light->sort;action;camera;dust;adjustment;option;shutter;priority;aperature;control;limitation;lag;light;flash;picture;zoom
medical->work;auto;mode;shoot
clean->quality;image
left->barrel;part;viewfinder;lcd;picture
