overpriced->apple
excellent->size;weight;system;tag;number;year;creative;business;quality;stuff;unit;look;cool;screen;battery;advantage;ipod;price;everyone;excellent;everything;company;life;fact;music;jukebox;form;factore;tip;pair;headphone;zen;star;class;rate;bookmark;example
cheap->advantage;ipod;player;plastic;rubber;corner
well-placed->control
bright->model;blue;screen
mp3->mp3;player;value;mediocre;software;jukebox;zen;track;fine;problem;money;cost;feature;sound;matter;stuff;screen;light;back;hell;music;transfer;control;scroll;button;heard;ton;equilizer;type;deal;lab;product;subject;headphone;box;dollar;pair;quality;roof;nomad;price;specs;buy;memory;shame;market;ipod;complaint;christmas;cd;space;pc;drive;work;dream;anything;anyone;appearance;harddrive;nothing;file;musicmatch;winamp;playlist;company;tag;hooray;size;fact;place
fine->mp3;player
previous->lcd;blue;backlight;screen
perfect->week;day;warranty
superior->ipod;bit;unit;size;software;song;level;player;clunky;suck;term;aac;apple;sub;par;music;service;store;problem;price;room;improvement;jazz;pop;equipment
ho-hum->system;case
nice->sound;battery;life;hour;rate;storage;size;firmware;update;price;playlist;fly;bit;software;bevy;eq;option;file;moment;random;fm;voice;extra;subject;headphone;mp3;player;box;dollar;quality;roof;scroll;sort;deal;lil;gadget;side;palm;hand;wheel;idea;clutter;scrolling;ipod;issue;something
interesting->customization
asthetic->folder;stucture
extraneous->creative;number;adjustment;example;compensate;car;train
better->predecessor;size;weight;tag;sound;number;year;creative;business;software;mp3;work;dream;anything;design;imo;ipod;filing;try;addict;decade;everyone;zen;regard;hardware;interface;navigation;backlit;screen
only->product;concern;tagging;process;way;software;sound;earphone;problem;case;headphone;cd;burner;cover;quality;longevity;button;battery;recharge;hour;zen;control;ipod;mp3;player;track;option;balance;star;system;playlist;nomad;computer
other->product;use;bull;fast;dont;software;panel;installation;hell;month;construction;flimsy;quality;interference;minute;battery;load;environment;ipod;device;leather;pouch;plus;unit;something;case;fail;hdd;mp3;value;track;minimal;pause;achievement;file;musicmatch;winamp;playlist;music;zen;tag;hooray;size;price;preference;earbuds;sony;kind;interface;nomad;front;cover;access;nothing;time;min;fall;control;location;button;side;artist;album;genre;lab;accessory;problem;result;operating;system;word;convenient;storage;capacity;collection;point;information;driver;trouble;zennx;running;replacement;review;headphone
bigger->ipod;palm;issue;something
easy->user;interface;collection;file;computer;vice;versa;sound;quality;stuff;unit;look;cool;battery;advantage;ipod;price;everyone;light;night;resolution;backlight;back;hell;music;transfer;control;scroll;button;heard;mp3;ton;equilizer;type;deal;silver;storage;playlist;fly
main->software;requirement;life;price;battery;apple;charge;fortune;hassle;factor;nomad
friendly->use;navigation;player;button;placement
inferior->defect;replacement;operating;do;patch
real->tip;headphone;firewire;card;battery;leather;case
good->music;storage;stuff;screen;light;back;hell;transfer;control;scroll;button;heard;mp3;ton;equilizer;type;accessory;lack;oversight;creative;marketing;zen;mp3s;side;everything;look;build;form;face;plate;hardware;ripping;way;ear;kbps;file;source;cd;minimal;pause;device;jukebox;problem;shame;market;viewing;hole;rate;preference;earbuds;sony;size;value;design;ratio;ipod;power;speaker;friend;feature;battery;life;flaw;song;connection;mediasource;mediaplayer;collection;disk;space;reality;driver;trouble;pocket;archos;dell;opinion;timer;play;mode;course;customization;option;unit;playlist;loud;work;variation
exceptional->flaw;size;price;buy
big->disappointment;couple;flaw;buyer;party;software;company;mediasource;file;transfer;issue;case;window;protection;scroll;button;sort;equipment;stuff;screen;light;back;hell;music;control;sound;heard;mp3;ton;equilizer;type;way;folder;structure;title;song;pc;size;inconvenient;road;cd;collection;device;album;counting;battery;everything;ipod;rca;dell;apple;charge;bone;replacement;support;time;variety;genre;equalizer;writing
unbeatable->product;friend;sound;quality;feature;battery;life
overall->song;level;clunky;format;suck;term;quality;aac;apple;ipod;sub;par;music;service;store;star;nothing;problem;havoc;while;room;doubt;headphone;jack;hissing;scroll;wheel;couple;flaw;buyer;party;company;mediasource;file;transfer;issue
cheaper->battery;life;fact;ipod
slick-looking->interface
replacable->sound;life;fact;price;ipod;user;apple
front->way;battery;case;notice;day;nomad;access;feel;device;construction;player;cheesiest;gap;base
aweful->earphone
notmad->notebook;time;mediasource;notmad;interface;chair;feature;week;improvement;file;player;musicmatch;winamp;playlist;music;company;tag;hooray
advanced->interface;chair;feature
cool->sound;quality;stuff;unit;look;cool;battery;advantage;ipod;price;everyone;silver;headphone;suck;feature
entire->objective;cd;device;room;storage;space;music;song;memory;amount;piece;fun;album;counting
large-capacity->day;album;collection;wherever;combination;price;capacity;feature;criterion
neccessary->gadget;side;player;palm;hand
batterly->hour;music;kbps;battery
automatic->song;transfer
bulky->player;folder;stucture
poor->construction;quality;product;difficulty;scroll;wheel;problem;headphone;jack;creative;zen;company;case
portable->quality;par;cd;bass;boost;ear;kbps;file;sound;source;zen;loud;work;speaker;fm;transmitter;unit;top;car;disappointment;gut;nomad;run;folder;lesson;company;product;way
peripheral->player;size;weight;system;tag;sound;number;year;creative
hard->cd;version;storage;device;party;software;folder;document;program;transfer;window;explorer;jukebox;file;nomad;store;structure;mp3;player;space;pc;case;briefcase;day;morning;class;computer;gut;run;lesson;company;product;way;music;source;ipod;construction;rubber;corner
second->mp3;product;software;song;level;clunky;suck;term;quality;aac;apple;ipod;sub;par;music;service;store
enclosed->problem;driver
sturdier->construction;archos;jukebox;kind;shock;carrying;thumbwheel;scroll;pushbutton
small->battery;apple;charge;hassle;factor;nomad;load;environment;construction;ipod;display;headphone;cavity;storage;cd;song;album;counting;player;user;interface;navigation
best->zen;christmas;combination;price;storage;size;feature;market;specs;memory;mp3;shame;quality;software;song;level;clunky;format;suck;term;aac;apple;ipod;sub;par;music;service;store;everything;category;buck;monster;work;gut;nomad;run;drive;folder;lesson;company;product;way;warranty;month;freeze;battery;navigation;wheel;money
blue->everything;stuff;back;hell;music;transfer;control;scroll;button;sound;heard;mp3;player;ton;equilizer;type;deal;night;lcd;model;lack;viewing;hole;face;case;rate
large->computer;lcd;info;silver;unit;album;track;information;user;interface;navigation;sound;ratio;ipod;power;output;zen;speaker;price;specs;buy;memory;mp3
dense->dense
navigational->player;size;weight;tag;sound;number;year;creative;business
normal->headphone;mp3;box;dollar;pair;sound;quality;roof
creative->size;weight;system;tag;year;creative;business;mp3;jukebox;quality;generation;jukeboxed;ipod;archos;dell;computer;friend;feature;battery;life;price;shame;market;window;mediaplayer;collection;service;catalog;burn;scratch;musicmatch;cd;track;strength;notmad;disappointment;couple;flaw;buyer;party;file;transfer;issue;construction;difficulty;scroll;wheel;problem;headphone;jack;lab;zen;playback;playlist;call;time;menus;month;device;manufacturing;control;response;customer;website;week;state;matter;pc;driver;help;winamp;hooray;limit;aspect;nomad;fact;place;content;offer;advantage;adjustment;example;compensate;noise;car;train;unit;future;question;replacement;warranty;day;vendor;accessory;consideration;stink;plain;intuitive
enough->receiver;car;radio;sennheiser;max;interface;playlist;song;product;sound;software;mood
various->button;side
new->price;fact;user;lid;popping;song;creation;list;phone;number;book;need;kind;device;headphone;stock;suck;anyone;mp3;organizer;ship;zen;driver;minute;crash;problem
changable->environment;construction;ipod
replaceable->quality;stuff;unit;look;cool;screen;advantage;ipod;price;everyone;zennx;factor;purchase;plus;leather;case;interface;software;timer;play;mode;apple;charge;fortune;hassle;nomad
hard-drive->pause;device;achievement
relatively-intuitive->player;size;weight;tag;sound;number;year;creative;business
backlit->backlit
great->apple;ipod;stuff;light;back;hell;music;transfer;control;scroll;button;heard;mp3;ton;equilizer;type;life;hour;rate;storage;size;firmware;update;feature;matter;mood;option;auditorium;zen;headphone;mp3s;volume;satisfactory;commute;noise;friend;earbuds;stack;cd;tape;interface;timer;play;mode;archos;dell;everything;opinion;ratio;power;speaker;line;lab;nomad;lithium;level;monster;part;work;ripping;way;d;crash;mp4s;list;memory;amount;song;collection;fun;cassette;adapter;car;eye;road;vendor;accessory;user;account
actual->player
noticeable->player;cheesiest;panel;base
resistant->construction;archos;jukebox;kind;shock
many->way;file;folder;structure;title;song;pc;gut;nomad;run;drive;lesson;company;product;player;option;music;auditorium;stuff;screen;light;back;hell;transfer;control;scroll;button;sound;heard;mp3;ton;equilizer;type;zen;christmas;experience;use;software;downfall;problem;window
price-wise->review;purchasing;zen
larger->model;blue;backlight;zen;backlit;volume;headphone;receiver;car;radio;inconvenient;road;durability;zero
favorite->feature;problem;software
terrible->price;ripping;way
lousy->player;week
whole->name
first->mp3;player;software;problem;front;cover;case;notice
major->jack;software;sound;quality;stuff;unit;look;cool;screen;battery;ipod;price;everyone
extra->work
simple->click;button;volume;display;access;use;instruction;software;control;inferior;ipod
powerful->interface;software;timer;play;mode
doesnt->mine;isnt;d;software;misfortune;crash;music;mp4s;list;f;kind;cash;something;course
select->creation;ipod;list;phone;number;book;need;kind;device
little->work;zen;archos;jukebox;kind;shock;case;memory;amount;song;collection;cd;fun;size;ipod
additional->window;explorer;jukebox;file;folder;nomad
decent->load;environment;ipod;predecessor;player;weight;system;tag;sound;number;year;creative;business
readable->blue
flimsy->month;buy;freeze;battery;navigation;control
tiny->amount;song;collection;cd;fun
next->month;reviewer;construction;flimsy;zen;stoppage;track;music;hesitation;click;progress
live->title;album;hit;frustration
much->way;access;scroll;wheel;equipment;ipod
dimished->mp3;file
biggest->price;fact;user;battery;lid;popping
consistent->quality;product;support;difficulty;scroll;wheel;problem;headphone;jack
more->time;hour;ac;adapter;scroll;bar;problem;task;playlist;frustrating;music
lowest->level;monster;part;work
removable->capacity;price;playlist;fly;sound;life;hour;rate;size;screen;firmware;update;year
difficult->scrollwheel
crappy->headphone
external->ratio;ipod;power;output;zen;speaker;volume;satisfactory;commute;headphone;receiver;car;radio
particular->jukebox
quick->becuase
user-replaceable->ipod
sound->hour;music;kbps;friend;feature;ipod;storage;firmware;update;player;zen;adjustment;custom;eq;band;matter;mp3;song;clunky;format;suck;term;aac;apple;sub;par;service;store;stuff;unit;look;cool;advantage;everyone;nomad;interface;timer;play;mode;file;excellent;everything;company;yoursound;jazz;pop;jukebox;generation;jukeboxed;archos;dell;boast;bit;flaw;buy;volume;normalization;line;jack;subject;headphone;box;dollar;pair;roof;product;problem;room;improvement;sony;factory;shame;market;reviewer;interference;minute;review;complaint;cd;bass;boost;stack;tape;light;back;hell;transfer;control;scroll;button;heard;ton;equilizer;type;deal;variation;course;customization;option;playlist;computer;audio;driver;trouble;mood;gut;run;drive;folder;lesson;way;mp3s;ratio;power;speaker;ear;source;opinion;predecessor;weight;system;tag;number;year;creative;business
high->backlight
third->disappointment;couple;flaw;buyer;party;mediasource;file;transfer;issue;zen;storage;device;folder;document;program;disk;window;content;computer
dynamic->call;time;menus
easier->organizer;ship;zen
back-up->serf;player
back-lit->lack;viewing;hole;face;case;transfer;rate
frustrating->nomad;run;drive;folder;lesson;company;product;way
beautiful->lack;viewing;hole;face;case;transfer;rate
ive->dell;ipod;everything;price;sound;opinion
shoddy->dollar
outstanding->source;ipod;drive;player
awesome->hour;sound;life;kbps;play;skip;run;bit;interruption;software;tag;database;access;song
40gb->level;part;work;sound;battery;life;fact;value;jukebox;consideration;zen;yesterday;gut;nomad;run;folder;lesson;company;product;way
now-blue->backlit
single->downfall;window
protective->desk;accident;fahrenheit;weather;design;fine;display;window;accessory;headphone;carrying
chic->player;form;face;plate
mediocre->mp3;software
annoying->screen;cover;hide
cumbersome->way;music;source;ipod;drive;player;scroll;model
low->sound;quality;player;room;improvement
huge->option;music;control;ipod;use;beginning;price;storage;playlist;fly;battery;ton;song;collection
different->variation;kind;interface;stuff;screen;light;back;hell;music;transfer;control;scroll;button;heard;mp3;player;ton;equilizer;deal;earbuds;headphone;zen;star;rate;christmas;profile;contrast;backlight;display;list;tabbed
defective->defect;replacement;operating;do;patch
convenient->convenient;storage;capacity;music;collection;point;information;battery;adapter;cable;recharging;choice
terrific->nomad
playback->ease;use;hardware;software;value;price;playback
useless->window;player;travel;song;beforehand
blue-screen->model;improvement;toggle;switch
3rd-party->earphone;software
cheesiest->cheesiest;panel;gap;base
yoursound->yoursound
painless->time;reset;button
most->player;musicmatch;winamp;playlist;software;music;company;zen;tag;hooray;battery;life;bulky;folder;stucture;scroll;wheel;time;curve;success;rate;device;firewire;complaint;card;quality;flaw;control;oddity;system
regular->earbuds
60gb->price;gig;ipod;comparison
lower->life
short->buy;freeze;battery;navigation;wheel
remote->pc
same-sounding->device
surprising->player;size;weight;system;tag;sound;number;year;creative
light->load;environment;construction;ipod
clear->everything;screen
battery-powered->running;price;replacement;battery
green->model;blue;screen
greatest->title;album;hit;frustration
serious->software;time;min;fall;mediasource;application;interface;flaw
audio->audio;file;music;time;player;limit;aspect;nomad;lab;predecessor;size;weight;system;tag;sound;number;year;creative;quality;reviewer;minute;synchronization;collection;computer;sense;sort;defeat;purpose;bookmark
