beautiful->print
fantastic->level
useful->picture
photo->print
awesome->print;quality;package
indoor->month;result;usage;scene;indoor;outdoor;macro;picture;shot;subject;foot;average;flash;drawback;distance;lack;contrast;color;problem
powerful->function
proverbial->sheer;fun;array;accessory;telephoto;cake
high->size;image;coolpix;compact;picture;journey;performance;camera;pixel;anyone;shoot;medium;price;range
sharp->camera;money;good;travel;image
best->feature;price;opinion;money;good;travel;image
compact->picture;photography;level;resolution;search
huge->state;buck;camera;print;package
little->film;scene;mode;fun;function;while;photograph;button;flash;marriage;feature;child;picture;journey;performance;size;quality;pixel;hand;awkward;person
incredible->picture
long->chip;camera;zoom;ability;closeup;mode
easy->win98;problem;battery;charger;cable;rich;auto;function;point;click;scene;mode;result;beginner;plenty;feature;camera;grandmother;control;coolpix;compact;size;photographer;pic;easy;sheer;fun;array;accessory;telephoto;cake;opinion;money;good;travel;image
digital->card;quality;picture;pixel;combo;function;model;convenience;child;anyone;digital;week;marriage;feature;resolution;search
good->shooting;capability;memory;quality;headache;term;function;chance;customer;service;opinion;money;good;travel;image;anyone;digital;week;indoor;shot;subject;foot;zoom;delay
spectacular->image
minutest->capture;detail
legendary->construction;optic
excellent->money;good;travel;image;coolpix;card;quality;picture;pixel;combo;function;model;convenience;beginner;feature;photographer;month;result;usage;scene;indoor;outdoor;macro;shot;pic
rechargable->chip;camera;zoom;ability;closeup;mode;unit
sheer->sheer;array;accessory;telephoto;icing;cake
great->anyone;digital;week;feature;print;brick;mortar;retailer;result;month;usage;scene;indoor;outdoor;macro;perspective;money;camper;chip;zoom;ability;closeup;battery;shot;pix;succession;action;movie
many->card;quality;picture;pixel;combo;function;model;convenience;camera;feature;annie;lebovitz;ability;store;month;result;usage;scene;indoor;outdoor;macro;correspond;situation
inside->pic;bit;adjustment;camera
user-friendly->card;quality;picture;pixel;combo;function;model;convenience;camera
first->feature
lasting->camera;zoom;ability;closeup;mode
