cute->game;information;manager;organizer;radio
sleek->addition
bright->color;tone;phone;shine;bright;command
higher->ring
subtle->phone;time
t-mobile->phone;menus;function;straight;manufacturer;baby;downside;writing;voice;quality;reception;place
previous->feature;shortcoming;menus;model;blessing;book;hour;number
perfect->quality;area;suburb;road;trip;signal;reception;stretch;route;feature;user;package;patience;flip;battery;life;bit;pocket
poly-graphic->foot;clarity;touch;phone
easy->regret
nifty->foot;clarity;touch
real->internet;service;access;estate;broker
good->headset;phone;ear;feature;fm;earpiece;weight;signal;array;whole;voice;place;coverage;level;mean;station;sprint;clarity;service;design;color;screen
new->life;polymer;technology
cool->speakerphone;radio
small->handsfree;problem;phone;button;fingertip;keypad;power;ton;research;speakerphone;option;plan;access;email;pocket;feature;user
nice->con;screen;speakerphone;currency;converter;stopwatch;picture;gsm;warranty;daylight;color
nonflip->nonflip
disturbing->game
best->range;patience;flip;cell
comaptible->gsm
normal->station;phone
slick->slick
superb->feature;pc;sync;suite;software;cable;port;bluetooth;speakerphone;reception;gsm;phone
international->world
available->page
full->africa;phone;bar
free->life;radio;signal;hand;function;java;apps
hands-free->phone
complicated->quality
key->space;text;input;bit;phone;layout;relation;rectangular;keypad;model;shape;hand;volume;design;flaw;call;visibility;lock;function;size;power
optional->radio
great->volume;complaint;battery;size;bit;radio;signal;hand;speakerphone;function;java;apps;review;feature;problem;right;box;world;service;work;charm;aim;technology;wise;speaker;week;area;suburb;road;trip;stretch;route;location;network;regret;research;option;plan;access;email;whole;ear;month;voice;place;coverage;chicago;customization;application
many->speaker;phone;radio;view;benefit;reason;appearance;pant;pocket;disappointment;menus;function;straight;manufacturer;fact;space;text;input;bit;background;memory;option
favorite->life;radio;signal;hand;java;apps;feature;game;information;manager;organizer;speaker;night;music;handset
american->chance;phone
decent->background;memory;option;power;radio;station
loud->currency;converter;stopwatch
first->station;handset;screen;nonflip
useful->message;aol;messenger;software;pain;stock;app;type;currency;length;area;phone;speakerphone
extra->feature;currency;converter;stopwatch
sweet->tune
powerful->addition
visible->bright
doesnt->phone;music;station;handset
little->department;piece;hardware;telephone;game;information;manager;organizer;radio;screen;user;interface;button;hand;kit;connector;problem;battery;life;polymer;technology;style;appearance;nokias;background;option;size;weight
additional->kind;stink;link;cable
positive->feature;sound;quality;fm;earpiece
tiny->power
few->inconvenience;feature;internet;problem;radio;tuner;world;country;gsm;asia
wonderful->world;feature
downloadable->foot;clarity;touch;phone;battery;life;radio;signal;hand;function;java
basic->feature;gsm
biggest->nokia;reception;gsm;phone
minor->inconvenience;feature;internet;problem
more->wallpaper;screensaver;clock;alarm;application;chess;currency;converter;web;page;phone;time
high-speed->image;gallery;option;camera;attachment;calendar;organizer;alarm;clock;snooze;radio;way;game;application;internet
high-pitched->volume
polyphonic->screen;mention;wallpaper;tune;tone;con;radio;feature
excellent->nokia;reception;gsm;battery;life;radio;hand;function;java;apps;book;volume;level;look;see;picture;feature;sound;quality;fm;earpiece;tone;con
pitched->ring
sound->sound;excellent;exception;phone;feature;fm;earpiece;tad;time;talker;end;line;volume;complaint;radio;tone;con
caller-id->picture
flip->phone;price;range;patience;flip
appealing->phone
nicest->phone
individualized->picture
constant->volume
sticky->hand;kit;connector;problem
high->feature;work;charm;aim
distorted->volume
annoying->phone;price;range;patience;flip
different->function;phone;wap;gprs;service;menu;option
other->feature;problem;right;box;color;combination;offer;voice;shortcoming;view;connection;message;aol;messenger;software;pain;application;picture;gsm;patience;flip;style;appearance;body;place;text;messaging
special->ring
difficult->power
okay->background;memory;option
unconventional->arrangement;shape;hand
beatiful->feature
such->phone
free-after-rebates->screen;shine;bright;command
mobile->picture
light->music;station;handset;pocket;battery;life;polymer;technology;signal;strength
clear->drop;area;experince;point;number;time;feature;currency;converter;stopwatch
traditional->shape;hand
ultimate->gsm
entertaining->game;phone
typical->chance;phone
